0	0	0	0	0	0	0
0	0	0	0	0	0	0
0	0	0	0	0	0	0
0	0	0	0	0	0	0
0	0	5	2	2	0	0
0	0	3	3	4	0	0
0	0	5	2	3	0	0
0	0	4	4	3	0	0
0	0	5	3	2	0	0
0	0	3	2	2	0	0
